XXXXXXXXXX
XPOIOOXOXX
XXOOOOOIOX
XOOOIOOOOX
XOOOOOXOIX
XOOXXOIXOX
XOOOOOOOOX
XOOXIOOIIX
XXOOXXOOOX
XXXXXXXXXX
