XXXXXXXXXXXXXXXXXXXXXXXXXXXXXXXXXXXXXXXXXX
XOOOOOOOOOOOOOOOOOOOOOOOOOOOOOOOOOOOOOOOOX
XOOOOOOOOOOOOOOOOOOOOOOOOOOOOOOOOOOOOOOOOX
XOOXOOOOOOOOOOOOOOOOOOOOOOOOOOOOOOOOOOOOOX
XOOXOOOOOOOOOOOOOOOOOOOOOOOOOOOOOOOOOOOOOX
XOOXOOOOOOOOOOOOOOOOOOOOOOOOOOOOOOOOOOOOOX
XOOXOOOOOOOOOOOOIOOOOOOOOOOOOOIOOOOOOOOOOX
XOOXXXXXXOOOOOOOOOOOOOOOOOOOOOOOOOOOOOOOOX
XOOOOOOOOOOOOOOOOOOOOOOOOOOIOOOOOOOOOOOOOX
XOOOOOOOOOOOOOOOOOOOOOOOOOOOOOOOOOOOOOOOOX
XOOOOOOOOOOOOOOOOOOOOOOOOOOOOOOOOOOOOOOOOX
XOOOOOOOIOOOOOOOOOOOOOOOOOOOOOOOOOOOOOOOOX
XOOOOOOOOOOOOOOOOOXOOOOOOOOOOOOOOOOOOOOOOX
XOOOOOOOOOOOOOOOOOXOOOOOOOOOOOOOOOOOOOOOOX
XOOOOOOOOOOOOOOOOOXOOOOOOOOOOOOOOOOOOOOOOX
XOOOOOOOIOOOOOOXXXXXXXOOOOOOOOOOOOOOOOOOOX
XOOOOOOOOOOOOOOOOOXOOOOOOOOOOOOOOOOOOOOOOX
XOOOOOOOOOOOOOOOOOXOOOOOOOOOOOIOOOOOOOOOOX
XOOOOOOOOOOOOOOOOOOOOOOOOOOOOOOOOOOOOOOOOX
XOOOOOOOOIOOOOOOOOOOIOOOOOOOOOOOOOOOOOOOOX
XOOOOOOOOOOOOOOOOOOOOOOOOOOOOOOOOOOOOOOOOX
XOOOOOOOOOOOOOOOOOOOOOOOOOOOOOOOOOOOOOOOOX
XOOOOOOOOOOOOOOOOOOOOOOOOOOOOIOOOOOOOOOOOX
XOOOOOOOIOOOOXOOXOOOOOOOOOOOOOOOOOOOOOOOOX
XOOOOOOOOOOOXXOOXXOOOOOOOOOOOOOOOOOOOOOOOX
XOOOOOOOOOOOOOOOOOOOOOOOOOOOOOOOOOOOOOOOOX
XOOOOOOOOOOOOOOOOOOOOOOOOIOOOOOOOOOOOOOOOX
XOOOOOOOOIOOOOOOOOOOOOOOOOOOOOOOOOOOOOOOOX
XOOOOOOOOOOOOOOOOOOOOOOOOOOOOOOOOOOOOOOOOX
XOOOOOOOOOOOOOOOOIOOOOOOOOOOOOOOPOOOOOOOOX
XOOOOOOOOOOOOOOOOOOOOOOOOOOOOOOOOOOOOOOOOX
XOOOOOOOOOOOOOOOOOOOOOOOOOOOOOOOOOOOOOOOOX
XOOOOOOOOOOOOOOOOOOOOOOOOOOOOOOOOOOOOOOOOX
XOOOOOOOOOOOOOOOOOOOOOOOOOOOOOOOOOOOOOOOOX
XOOOOOOOOOOOOOOOOOOOOOOOOOOOOOOOOOOOOOOOOX
XOOOOOOOOOOOOOOOOOOOOOOOOOOOOOOOOOOOOOOOOX
XOOOOOOOOOOOOOOOOOOOOOOOOOOOOOOOOOOOOOOOOX
XOOOOOOOOOOOOOOOOOOOOOOOOOOOOOOOOOOOOOOOOX
XOOOOOOOOOOOOOOOOOOOOOOOOOOOOOOOOOOOOOOOOX
XOOOOOOOOOOOOOOOOOOOOOOOOOOOOOOOOOOOOOOOOX
XOOOOOOOOOOOOOOOOOOOOOOOOOOOOOOOOOOOOOOOOX
XXXXXXXXXXXXXXXXXXXXXXXXXXXXXXXXXXXXXXXXXX