XXXXXXXXXXX
XPOIXOIOOOX
XOXXXXXOXIX
XOXOXOXIXOX
XIXIXOXXXOX
XOOOOIXOIOX
XXXXXOXXXOX
XOOIOOXIOOX
XIXXXOXXXOX
XOXOIOOOOIX
XXXXXXXXXXX