XXXXXXXXXXXXXXXXXXXXX
XOOIOOIOXOXOIOOOXOOOX
XOXXXOXXXOXXXOXXXIXOX
XOIOXOIOXOIOXOIOOOXIX
XOXXXOXOXXXOXXXXXXXOX
XOXOIOXIOOOIXOXIOOXOX
XOXXXXXOXOXXXOXXXOXOX
XIOOXOOIXOOIOOOOOOIOX
XOXXXXXOXOXOXOXXXOXXX
XOOOXIXOXIXOXIOOXOXIX
XIXXXOXOXOXXXXXXXOXOX
XOXOOIOOXIXOIOOOXIOOX
XXXOXOXIXOXOXXXXXXXOX
XOIOXIXOXOOOXOXOIOOOX
XIXOXXXXXOXXXOXXXOXOX
XOXIOOXIXOIOXOIOXOXIX
XOXXXOXOXOXXXOXXXOXXX
XIXOOIOOXOXIXOXIXIXIX
XOXOXOXOXIXOXOXOXOXOX
XOXOXOXOXOXOOOIOOOPOX
XXXXXXXXXXXXXXXXXXXXX