XXXXXXXXXXXXXXXXXXXXXXXXXXXXXXXXXXXXXXXXXXXXXXXXXXXXXXXXXXXXX
XOOXOOXOOOIOOOOXOOOOIOOOXOOOIOXOOOOIOOOXOOOOOIOOXOOOOIOOOOOOX
XOOXOIXOIXOOXXXXOOXOOXXXXOOXOOXOIXOOXXXXXXXXXXOOXOOXXXXXXXXXX
XOIOOOXOOXOIXOOXOIXOOXOOOIOXOOXOOXOOOIOOOOXOOOIOOOOOOOOOOXOOX
XOOXOOIOOOOOXOOOIOOOOXOOXOOOOOIOOXOOOOOOOOXOOXOOOOOXOOOIOOOOX
XOOXOOXOOXXXXXXXXXXOOXXXXXXXOOXXXXXXXOOXXXXOOXOOXXXXOOXXXXOOX
XOOOIOXOOIOOXOOOOOXIOOOOOOOXOOIOOOOIOOOOOIXIOXIOXOOOIOXOOXOOX
XOOXXXXXXXXXXXXXOOXOOXXXXXXXXXXXXXXXXOOXOOXOOXXXXXXXXXXOOXOOX
XOIXIOXOOOIOXIOXOOOOOIOOXOOOOIOOOXOOOIOXOOOIOXOOXOIXOOOOOIOOX
XOOXOOXXXXOOXOOXOOXOOXXXXOOXXXXXXXOOXXXXXXXXXXOOXOOXXXXOOXOOX
XIOOOOXOIXOOOIOXOIXOOOOIOOOXIOXOOXOOOIOOOOOIOXOIOOOIOOXIOXIOX
XOOXXXXOOXXXXOOXXXXOOXOOXOOXOOXOOXXXXXXXOOXXXXOOXOOXXXXOOXXXX
XOOXOOOOOXOOOOOOOIOOOXOOXOOOOOXOOIOOXOOOOOIOOXOOXOIOOOOOIOOOX
XOOXOOXXXXOOXXXXXXXOOXOOXXXXXXXOOXOOXOOXXXXXXXXXXXXXXXXOOXXXX
XOIOOOOOIOOOXOOOOOXOOXOOOIOOOOXOOXOOOOOIOOOOOIOOXIOXOOOIOOOOX
XOOXXXXXXXOOXOOXXXXXXXOOXOOXXXXXXXOOXXXXOOXXXXXXXOOXOOXXXXOOX
XOOXOOOIOOOOOIOXOOXOIXOOXIOXOOXOOIOOXOOIOOXOOOOOIOOXOOXOOXIOX
XOOXXXXXXXXXXOOXOOXOOXXXXXXXOOXOOXXXXXXXOOXXXXOOXOOXOOXOOXXXX
XOOIOOOOIOOOXOOXOOOIOXOOXOOIOOXOOOOOXOOXOOOIOOOOXOOXOIOOOXOOX
XOOXXXXOOXXXXXXXOOXXXXOOXOOXXXXXXXXXXOOXXXXXXXOOXXXXXXXOOXOOX
XOOIOOXOOOOOOIOOOOXOOOOOIOOXOIOOOXOOXOOIOOXOOIOOXOOOIOOOOXIOX
XXXXOOXXXXOOXXXXXXXOOXOOXXXXXXXPOXOOXOOXXXXOOXXXXXXXXXXOOXOOX
XIOOOOXOOIOOXOOXOIOOOXOOOIOXOOOOIOOOXOIOOOXOOOOIOOOXOOOIOOOIX
XOOXXXXXXXOOXOOXOOXOOXOOXOOXOOXOOXXXXOOXXXXOOXOOXOOXXXXOOXOOX
XOOXOOOIOXOIOOOOIOXOOXIOXOOXOOXOIXOOOOOOOIOOOXOOXOOXOOXOOXOOX
XOOXXXXOOXOOXXXXOOXOOXOOXXXXXXXOOXXXXXXXOOXXXXXXXXXXOOXXXXIOX
XOIOOOOOOXOIOOOXOOXIOXOOXOOOIOOOOXOIXOOXOOOIOOOOXOOOIOOOOIOOX
XOOXXXXXXXOOXXXXOOXOOXXXXXXXOOXXXXOOXOOXXXXXXXOOXXXXXXXOOXXXX
XOOXOOIOOOOOOIOXOIXOOOOOOIOOOOOOOXOOXOOOOOOIOOOOOOIOOOXOOXIOX
XOOXOOXXXXXXXIOXOOXXXXOOXOOXXXXXXXOOXOOXXXXOOXXXXXXXXXXOOXOOX
XOIXOOXOOOOOXOOXOOXOOIOOXOOXOOOOIOOOOOOXOOXOOOOOOOOOOOOIOOOIX
XXXXXXXXXXOOXOOXXXXXXXXXXXXXXXXXXXXXXXXXOIXXXXXXXXXXOOXOOXOOX
XOOOIOXOOIOOXOIOOOOOOXOOOOOIOOIOOXIOXOOXOOOOOOOIOOOXOOXOOXOOX
XOOXOOXXXXOOXOOXOOXXXXOOXXXXXXXXXXOOXOOXXXXOOXOOXXXXOOXOOXOOX
XOIXOOOIOOOOOIOXOIOOOOIOXOOXOOOIOOOOOOIXOOXOOXOOOOOIOOXOIXIOX
XXXXXXXOOXXXXOOXOOXXXXOOXIOXXXXOOXXXXOOXOIXOIXXXXXXXXXXOOXOOX
XOIOOOXOOIOOXOOXOOIOOXOOOOOOOOOIOXOOXOOXOOXOOOIOXOIOOOXOOXOOX
XOOXOOXOOXXXXXXXOOXXXXXXXOOXXXXOOXIOXOOXOOXXXXOOXXXXOOXXXXOIX
XOOXOIOOOXOOOOIOOOIOOXOOOIOOIOXOOXOOOOOOOOOIOOOOIOOOOOIOOXOOX
XXXXXXXXXXXXXXXXXXXXXXXXXXXXXXXXXXXXXXXXXXXXXXXXXXXXXXXXXXXXX
